#####
#@$.#
#####
;
 ########
##      #
#       #
#   $   #
# .$@$. #
####$   #
   #.   #
   #   ##
   #####
;
#########
# . . . #
# $ $ $ #
#   @   #
#########